-1 -1 -1 1 -1 -1 -1 -1 -1 -1 
-1 -1 -1 0 -1 -1 -1 -1 -1 -1 
-1 -1 15 16 17 -1 -1 20 -1 -1 
-1 -1 -1 -1 -1 -1 -1 19 -1 -1 
-1 -1 -1 -1 -1 -1 15 16 17 -1 
-1 -1 -1 -1 -1 -1 -1 -1 -1 -1 
-1 -1 -1 10 12 -1 -1 -1 -1 -1 
-1 -1 10 11 13 12 -1 -1 1 -1 
-1 10 11 14 14 13 12 -1 0 -1 
2 11 14 14 14 14 13 3 3 4 
